Name	title	coding
t3_qly38g	COURSE QUESTION	c
t3_qo0c3s	BTM salary upon graduation?	o
t3_qmx5wu	What's going on at Space Concordia	c
t3_qn0dnv	Self-study source for MATH and PHYS	c
t3_qo26js	Permanent code international student.	o
t3_qqk482	How much financial aid money do I lose if I disc a class?	o
t3_qmz7j7	Can anyone share the Econ 301 course outline with me?	c
t3_qq9ztp	Surveys about Hair Salons and Nail Salons for COMM 210 Class	c
t3_qmm8cj	Math 204 Advice ?	c
t3_qlzy5z	About PHYS284	c
t3_qn079w	Soccer Tournament	o
t3_qqi45f	Students who live alone. How you manage it out and what is your budget	o
t3_qr12pu	US students what gpa did you have when you applied to concordia	o
t3_qp4jb2	Canadian citizen ship	o
t3_qpyg82	Ontario Transfer to Concordia University	o
t3_qqkvnz	Maple Telemedicine service	f
t3_qncmqz	Anyone know any good psychoanalysts around?	o
t3_qoec88	Construction Engineering and Management (MEng)	c
t3_qpl6dx	Work-study program	o
t3_qoxt8d	What would people say is the easiest math course to take a Concordia?	c
t3_qqhr4n	math 204 crash course?	c
t3_qo1ena	Anyone down to practice leetcode and tech interview questions?	o
t3_qljdz5	SOS TUTORING	c
t3_qq5d1b	COMP 335 Syllabus	c
t3_qqb0oc	Comp 218	c
t3_qq6isg	PHYS204	c
t3_qmnj38	Freshman Questions	o
t3_qqpo5q	Don’t go to Concordia for arts	o
t3_qnqvld	How Prof Aimaan Hanna knows everyone name by face, even though all new students never met him ?	o
t3_qpe7hw	Housing Accomodation	r
t3_qlkt9z	STL (Laval Buses) Strike: November 3rd, 15th, 26th	o
t3_qpkgv0	Do you drink coffee in the morning?	f
t3_qndfs9	Is there a limit to how many DISC you can have?	c
t3_qlyd20	CAQ and Study Permit	o
t3_qq9nd3	Failed Math 208 Midterm	c
t3_qm3emw	Confusion Regarding Admission	o
t3_qnf3mt	To do checklist on student centre after I applied (I'm international so it asks for like visa expense documents, etc), do I need to do it before or after I have a decision?	o
t3_qnrgvm	Coffee shops to study!	r
t3_qoumus	Comm 215	c
t3_qpuhjr	Have four courses, planning to disc one tonight. Would I become a part time student?	c
t3_qple7p	Did not meet the requirements on conditional offer	o
t3_qm5my8	looking for paid tutorials	c
t3_qpr2og	Guys , what’s the best website/app to find apartments for rent for students?	r
t3_qp5j44	Concordia or uwindsor	o
t3_qogisc	Chem 203	c
t3_qm1eee	Teamwork with 10 teammates	o
t3_qnqr6v	Conditional Offer of Admission	o
t3_qmavtc	Unable to DISC co-requisite course	c
t3_qpxh7l	PHYS 206 - Route of least resistance?	c
t3_qlgutl	Can we Petition Removal Of A Prof From A Teaching Position?	c
