Name	title	coding
t3_qqn7bu	ECON 257 A3	c
t3_qpma8y	How long does it take to get official transcripts?	c
t3_qq0d9v	Should I wait until the status of the medical exam is updated to arrive?	o
t3_qqx044	Reaching out to a professor?	c
t3_qow0ax	Any McGillians Working in Toronto This Winter?	o
t3_qnu45p	Pottery stations in montreal	o
t3_qp0a8e	Anyone willing to share psyc 213 notes?	c
t3_qp87j2	On-campus study spots with nice outside view ?	o
t3_qqzdrh	Class rank for MSc. application?	c
t3_qqcxo7	How to review for Comp 250/273?	c
t3_qp536l	BIOC 311. oh my god	c
t3_qnu3xn	Any fans of Better Call Saul?	o
t3_qqcztm	Has your exchange application been reinstated?	o
t3_qqmzrs	How does taking a course or two at Concordia work?	c
t3_qp5rs9	COMP 252	c
t3_qpfm5z	Flags lowered in memory of deceased students: Cause of death?	o
t3_qpishs	Fast pass sticker??	o
t3_qqa0m5	Classes not being in person this winter....	c
t3_qqf5wt	Get Paid to do Self-Guided Research! McGill Journal of Human Behavior Research Fellowship	o
t3_qp2flr	Was Just Informed that I am not Going to Make it in the Workforce	o
t3_qqlli3	Anyone else gonna be an old ass undergrad?	o
t3_qp6gu4	good news monday	o
t3_qquzwa	covid testing at hotel dieu: questions	o
t3_qplrde	Comp 598 students: Should res provide better vegetarian food options?	r
t3_qoaub9	Wrongfully Accused in Math 133 of Cheating	c
t3_qpjb3c	Which advisor should I contact to talk about switching faculties?	o
t3_qqrn2l	Feeling bummed knowing I donâ€™t got what it takes to make it to medicine	o
t3_qqdm8o	Group chat for Econ408	c
t3_qqwdur	Working at a residence dining hall?	r
t3_qodyxq	Wellness hub replacement?	r
t3_qq6ao9	OSD Exam Procedure	c
t3_qou8zc	fall 2021 SSMU referendum starts tomorrow!	o
t3_qqd74r	In need of a study buddy	c
t3_qnu7f4	Where are some quiet areas of Montreal?	r
t3_qpkcxp	Peculiar microwave ?	f
t3_qocst2	SSMU Dental Insurance maxed out, what should I do	o
t3_qqllz3	Unlimited Maple appointments ?	f
t3_qns1ue	Petition for Thomson House Menu change!	f
t3_qpt94m	FINE 441 projects	c
t3_qq9hxp	Is there a difference between PSYC 395 and 494?	c
t3_qp884q	My only source for a reference doesn't want to be a reference - what to do?	o
t3_qphe5x	Starting a band	o
t3_qov9br	Winter term at Udem?	o
t3_qpkoxu	"Anyone else getting constant ""Unexpected Server Response"" on mycourses when trying to access documents?"	c
t3_qnqejc	Final exams and webwork	c
t3_qp3xao	To full time students/part time workers in the Life Sciences program, what should be the maximum amount of hours you allot for work without compromising your studies??	c
t3_qpd7vg	Is there free COVID testing for McGill students?	o
t3_qpdtsm	International student insurance coverage for consultation with a doctor outside McGill	o
t3_qod30w	Where to buy Honeycomb?	f
t3_qp5hbh	anyone took mgcr 382 with Nicholas Matziorinis?	c